// 使用 "//" 放在行首可以跳过该行，可在其后写上注释
IoT==internet of things==internet of thing
distribute ledger==distributed ledger technology==dlt==distribute ledger technology==distributed ledger
blockchain==block chain==block-chain==bc-blockchain==blockchains
consensus==consensus algorithm==consensus protocol==consensus mechanism==protocol==selfish mine==double spending==double spend problem==double spend==byzantine fault tolerance==byzantine fault==byzantine fault tolerant consensus==crash fault tolerance==crash fault tolerant consensus==zero-knowledge proof==zero-knowledge-proof==zero knowledge proof==zkp==zero-knowledge==vote-based consensus==vote==voting-based==vote-based==proof-based consensus==proof-based==mining pool==mine pool==proof-of-work==pow==proof of work==proof-of-work system==proof-of-stake==pos==proof of stake
p2p network==peer-to-peer==peer-to-peer compute==p2p==peer to peer
e-health==ehealth==e-healthcare
industrial iot==iiot
supply chain==supplychain==supply chain management
industry==industry 4.0==industry 40==i4.0
cryptography==key==encryption==public key==encryption algorithm==rsa==ecc
healthcare==health care
bitcoin==bit coin
smart contract==smart-contract==contract
cryptocurrency==crypto currency==cryptocurrencies
review==literature review==systematic literature review==systematic review
dapp==dapps
artificial intelligence==ai
deep learning==deep learn
machine learning==machine learn
compute==cloud compute
data storage==computer data storage==information storage system==storage architecture==distribute storage==storage management==distribute file storage
security==communication security==security service==security and privacy==cyber attack==cyber-attack==cyberattack==network attack==human and societal aspect of security and privacy==cyber security==cybersecurity==network security==system security==distribute system security==authentication==vulnerability==computer security==formal verification==cyber attack==computer crime==data security==attack==volatility==verification==intrusion detection==vulnerability==threat==risk==information security==model check==threat model==distribute system security==system security==communication security==human and societal aspect of security and privacy==risk management==ddos==denial-of-service attack==cybercrime==operational risk==credit risk==cyber spy==stateful firewall==secure network==do attack==eclipse attack==sybil==cloud compute security==provable security==ghost==unforgeable==threat factor==mine attack==security issue==security level analysis==threat model analysis==security threat==cyberattacks==secure multi-party computation==stalker attack==51% attack==security assurance==security vulnerability==security protocol==crytography==hardware security module==iot security==risk research==technical risk==risk-benefit==decentralize pki==mean-risk analysis==security challenge==tamper resistance==resistance==secure bill==social aspect of security==risk assessment==uc-security==cutlery fork==application security==denial
privacy==security and privacy==data privacy==information privacy==human and societal aspect of security and privacy==privacy-preserving==privacy protection==preserve privacy==privacy-preserving technology==privacy-preserving smart contract==data integrity
performance==data storage==scalability==throughput==computer performance==performance evaluation==performance evaluation criterion==network performance evaluation==performance model==firm performance==performance analysis==network performance analysis==performance optimization==performance evaluation criterion
interoperability==interoperability of information==interblockchain
regulation==law==monitor==compliance==legislation
governance==coordination
usability==reliability
// 可使用 nothing 代替准备去掉的话题词，如 blockchain，review，tutorial 等等
nothing==review==blockchain==NaN==technology==application==distribute ledger==
